5 6
######
#@E $#
# N  #
#X   #
######