5 5
#####
#   #
# $ #
# @ #
#####